text	label	prediction
请介绍几种全英文的报纸,有关时政或各种新闻的适合在校大学生看的	推荐类	推荐类
怎么找不到 “It Nerver Rains In Southern Califormia”这首英文金曲的歌词?	原因类	原因类
珠海K歌之王的酒钱是多少?	事实类	事实类
蔡依林在哪开演唱会	事实类	事实类
罗志祥是哪个公司的啊	事实类	事实类
春晚门票多少钱一张?	事实类	事实类
还有多少人会观看了春晚?	事实类	事实类
问一下~~阮经天参加过哪个女明星的mv的拍摄~~	枚举类	枚举类
说说你们最喜欢Vae的哪首歌。	推荐类	推荐类
音乐美在哪里	评价类	评价类
JAY开过哪些演唱会?	枚举类	枚举类
刘德华和张学友谁帅?	评价类	评价类
super junior拿过什么奖?	枚举类	枚举类
许巍现在出了新的专辑吗?	事实类	是非类
专辑在哪有卖?(张杰的)	需求类	需求类
推荐几个灵魂乐的歌手	推荐类	推荐类
张韶涵出过书吗?!~!~!~	需求类	是非类
谁知道罗志祥一月十号上海签唱会的具体时间啊?	事实类	事实类
谁知道周杰伦的家在哪	事实类	事实类
王力宏新歌《我完全没有任何理由理你》中说的都是谁	事实类	枚举类
为什么我每次想哭的时候都会去听《show me love》这首歌?谁可以告诉我?	原因类	原因类
擦肩而过的作词者是谁	事实类	事实类
怎么下载QQ音乐中URL地址的音乐	方法类	方法类
谁有好的点的看电影或音乐的好网址?	推荐类	推荐类
家驹在天堂多少年啦??	事实类	事实类
谁有jay的演唱会票	需求类	需求类
蔡妍最后一次参加的X-MAN 跳舞的歌名是嘛?	事实类	事实类
有没有东方神起的AAC格式的MV?	需求类	需求类
不是因为寂寞才想你,是因为想你才寂寞.这个歌谁唱的.是女声的噢,.不是男的。	事实类	事实类
哪里有黄家驹的所有歌曲啊?	需求类	需求类
喜欢王子的歌迷有名字吗,叫什么?	事实类	事实类
东方神起2008年在上海开过几次演唱会	事实类	事实类
谁知道模范棒棒堂哪一期是范晓萱参加的呀?	事实类	事实类
大家都喜欢飞轮海的那一点啊?	评价类	评价类
谁有陈冠希小时候的照片?	需求类	需求类
谁知道承诺的歌词??	需求类	需求类
东方神起各个成员有整容吗?	是非类	是非类
飞轮海和东方神起还有sj-M组合那组最帅?	评价类	评价类
有谁知道 BK LOVE 的中文歌词?	需求类	事实类
SHE新专辑的歌都有些什么啊?	枚举类	枚举类
在韩国MC是指?	事实类	描述类
sj-m中,周觅和Henry,更喜欢谁?	评价类	评价类
林俊杰拍的有什么电视剧好看??	推荐类	推荐类
Rain和安七炫那个帅?	评价类	评价类
模范棒棒堂里有什么人	枚举类	枚举类
今年.,音乐盛典蔡依林得了什么奖?	事实类	枚举类
至上励合有多少人组成	事实类	事实类
邪恶少年eb的资料和他全部歌的歌词哪有?	需求类	需求类
李贞贤在第6届中韩歌会唱得啥歌了?	事实类	事实类
我也特别的喜欢韩庚,不过我想知道哦有多少人喜欢韩庚啊?	事实类	事实类
你是我的天堂mp3的歌词哪里有	需求类	需求类
谁能给我妖精之歌的歌词?	需求类	需求类
北京欢迎你有哪些明星录了的	枚举类	枚举类
周杰伦祖籍是哪	事实类	事实类
周杰伦续上海站后下一站演唱会在哪里开?	事实类	事实类
有喜欢神起和SJ的吗?最喜欢是18只中的哪一位呢!呵呵!	评价类	推荐类
michael jackson的新专辑好久发行??	事实类	事实类
韩庚拍过什么MV吖!!	枚举类	枚举类
蔡依林的MV哪个好看?	推荐类	推荐类
请问神话组合08年参加了什么节目?	枚举类	枚举类
东方神起代言过哪些牌子?	枚举类	枚举类
周杰伦可爱在哪里?	评价类	评价类
为什么时下的流行歌总是些失恋,分手的歌?	原因类	原因类
《我在那一角患上过伤风》这歌谁作曲的????	事实类	事实类
JAY的十大金曲是哪十首?	枚举类	枚举类
杰伦何时来美国开演唱会?	事实类	事实类
神起出过几张专辑?	事实类	事实类
我型我秀里的组合叫什么名字	事实类	事实类
北京欢迎你韩庚拍摄地点在哪里	事实类	事实类
2007CCTV综艺盛典在哪举行?	事实类	事实类
张杰他妈妈的店在哪	事实类	事实类
qq宠物熊什么时候再放号啊?	事实类	事实类
谢霆锋和张柏芝的儿子何时出生?	事实类	事实类
谁是韩庚?给我介绍介绍,好多朋友多说他好...	描述类	描述类
谁知道标准的我爱久久的歌词啊?	需求类	需求类
唱<<飞向别人的床的>>光光是谁?	事实类	事实类
谢娜和张杰的身高分别是多少	枚举类	枚举类
RAIN的新专辑都有甚么歌?	枚举类	枚举类
SJ-M的主打歌U的歌词是什么?	需求类	事实类
ss501的人气是多少?	事实类	事实类
有一个女模特.在中国人看来很丑.但是她跑带外国就很受欢迎.她叫什么名字?	事实类	事实类
Jay的祖籍是哪里的??	事实类	事实类
super junior 有一个MV是韩庚和始源拍的,那个MV是哪首歌的?	事实类	事实类
"东方神奇唱的""咒语”歌词是?"	需求类	事实类
韩庚2008在哪个公司	事实类	事实类
谁有飞轮海的签名相?	需求类	需求类
东方神起现在用的手机是什么牌子的(型号也要说)	事实类	事实类
想找个好听点的嗨曲谁推荐个?	推荐类	推荐类
有谁知道六线谱的网站就是弹吉他用的	需求类	需求类
俞灏明的EP在哪里有买?	需求类	需求类
哪个给我一个不错的音乐社区	需求类	推荐类
山寨春晚哪个网站直播啊?	需求类	需求类
为什么每个明星都有艺名?	原因类	原因类
SJ出演过什么节目	枚举类	枚举类
那里有刘亦菲和成龙参加快乐大本营的视频(6月初的)?	需求类	需求类
晴天的歌词可以告诉我么/?~ `	需求类	需求类
张力尹到底是哪国人啊	事实类	事实类
在哪可以买张杰正版的歌碟?	推荐类	需求类
韶涵和谁最配?	推荐类	推荐类
如果唐禹哲要加入飞轮海里,但必须还是四个人你觉得让谁下去比较好捏?	推荐类	推荐类
周杰伦西安演唱会视频在哪看?	需求类	需求类
明道-阮经天-谁才配的上陈乔恩?	评价类	评价类
刘亦菲家在北京的具体位置在哪?	事实类	事实类
<<深深爱过你>>(薛之谦) 共有几个版本?	事实类	事实类
贝多芬的代表作有哪些?	枚举类	枚举类
信乐团共有几张专集?	事实类	事实类
有谁的摇滚比较好听的,告诉我哦!	推荐类	推荐类
谁有好点的音乐?	推荐类	推荐类
怎么找新的流行音乐?	方法类	方法类
J-Rock的舞在世界排多少?	事实类	事实类
娱乐圈谁比较红	推荐类	推荐类
王菲的 歌:将爱 歌词是什么	需求类	需求类
一个玩摇滚的鼓多少钱?	事实类	事实类
谁知道什么歌的网站	推荐类	需求类
钢琴的网站都那些?	需求类	枚举类
谁有比较伤感的音乐啊???	推荐类	推荐类
谁能把周杰伦所有的歌给我啊	需求类	需求类
有没有70-90年代的老歌手的歌或人?..	推荐类	推荐类
最近有什么刚出道的明星	枚举类	枚举类
滨崎步的歌有多少首?	事实类	事实类
谁能帮把郑源所有的歌给我啊?	需求类	需求类
有什么网站可以找到好听的歌?	需求类	推荐类
谁知道最好听的音乐网站是多少?	推荐类	推荐类
有什么网站听歌好一点..更新快点的?	推荐类	推荐类
"谁帮我将""情人不会忘记""剧情版的歌词打出来?"	需求类	需求类
为什么我的QQ音乐听过的音乐无法出现在列表中?	原因类	原因类
一首不知道的歌名	事实类	事实类
为什么喜欢听抒情的歌?	原因类	原因类
为什么现在没有特别好听和动感的歌曲?	原因类	推荐类
谁先发现了音乐?	事实类	事实类
谁知道可爱点的音乐啊?	推荐类	推荐类
SJ分了几只	事实类	事实类
怎样的人喜欢伤感的歌?	原因类	评价类
哪里有好听的RAP?	需求类	推荐类
Jay和JJ谁在娱乐圈里待的时间会更长一些?	评价类	评价类
非主流歌网站有谁知道??韩国非主流歌的网站也要!!!	推荐类	推荐类
对不起我爱你的歌词是谁写的?	事实类	事实类
网络歌曲,谁知道CK的歌.最好能下载的	需求类	需求类
说好的幸福呢?歌词 谁有?	需求类	需求类
你们最喜欢的歌词是那一句啊,.?	推荐类	推荐类
那位知道《摇滚怎么了》的歌词?	推荐类	需求类
王力宏是多久出名的.?	事实类	事实类
<想太多>. 是哪个的歌..?	事实类	事实类
<北京欢迎你>的MV和歌是怎么拍摄的?	描述类	方法类
世界上谁的歌好听啊	推荐类	推荐类
QQ音乐要多少分才能点亮?	事实类	事实类
我的个性签名那个位置怎么不能显示我的QQ音乐所听的歌啊?	方法类	原因类
我想知道最进的歌手新歌谁排在第一位	推荐类	推荐类
现在流行的英文歌及歌手?	推荐类	推荐类
谁有黄家驹所有的歌?	需求类	需求类
何洁和谁一起唱Boy	事实类	事实类
飞轮海里有里些人?	枚举类	枚举类
谁有东方神起的所有的歌?	需求类	枚举类
JAY的歌你们知道多少~~~	枚举类	枚举类
关于奥运会的歌一共有几首?	事实类	事实类
现在谁最有钱?在娱乐圈?	推荐类	推荐类
2010年春晚有什么节目	枚举类	枚举类
为什么明星都看起来比较好看	原因类	原因类
谁知道最近有没有刚出道的明星?	枚举类	枚举类
BOBO是内地最红的组合吗	评价类	评价类
我不知道你在想什么的这句歌词是谁唱的	事实类	事实类
谁有<爱我别走>得歌词?周杰伦的!	需求类	需求类
有你们觉得很好听的老歌吗?	推荐类	推荐类
信乐团开过哪些演唱会?	枚举类	枚举类
谁的慢歌好听?	推荐类	推荐类
郑源的个有多少人喜欢	事实类	事实类
最新的非主流歌曲名字???	枚举类	推荐类
罗志祥个人博客是什么网址啊	事实类	事实类
张学友现在几岁那?	事实类	事实类
谁有张学友专辑	需求类	需求类
信乐团有几个人组成的?	事实类	事实类
谁听过这个歌词知道的告诉下	事实类	事实类
谁知道《星星》这首歌的歌词?	需求类	需求类
最火的DJ叫什么名字	推荐类	推荐类
歌特是什么风格?	事实类	事实类
王力宏的歌曲有多少	事实类	事实类
有舞曲的吗?给我点啊	推荐类	推荐类
谁有DJ的歌要舞曲	推荐类	需求类
伤心的时候可以听情歌谁唱的	推荐类	推荐类
谁唱的情歌好听	推荐类	推荐类
现在哪里最新的歌下载呢?	需求类	需求类
- -! 哪里有好听的歌诶	推荐类	推荐类
问一下这首歌的歌名叫怎么?	事实类	事实类
谁的歌曲最好听?	推荐类	推荐类
"急求:""世界有有名的钢琴曲和JAY流行歌曲钢琴版本MP3网址?"	需求类	需求类
谁能帮我弄个曲子啊	推荐类	需求类
谁有QQ音乐种子给我2个咯	需求类	需求类
五月天共有几首歌,歌名写出来~要绝对全的	枚举类	事实类
网络歌手长的---peerless的歌词中文翻译是什么?	描述类	描述类
真的爱你是黄家驹为谁写的歌?	事实类	事实类
有什么网站下载音乐比较好啊?最好可以一下子下载很多的那种。	需求类	推荐类
近期的新歌啊?	枚举类	枚举类
jay现在又出新歌没有啊?知道的人告诉我一下?	是非类	是非类
你觉得JAY和谁最配啊?	推荐类	推荐类
爱我别走是JAY无与伦比演唱会唱的?	是非类	是非类
SHE的新专辑销量是多少	事实类	事实类
在网上有谁能教我唱歌	需求类	方法类
SJ里面有几个中国人?	事实类	事实类
济南哪里有卖许嵩专辑的?	需求类	需求类
许嵩的专辑哪有卖的?	需求类	需求类
谁知道飞轮海的新专辑	事实类	事实类
任贤齐老婆是谁叫什么	事实类	事实类
Eminem除了在纽约开过演唱会还在哪开过?	枚举类	枚举类
在那能找伤感的有节奏的歌曲??	需求类	推荐类
男歌手谁比较帅	推荐类	推荐类
娱乐圈到底是甚么?	描述类	描述类
现在有什么好看的男明星(30岁以下)	推荐类	推荐类
你最喜欢的明星的资料,推荐一下?	推荐类	推荐类
JAY的中国风歌曲?	枚举类	枚举类
什么歌唱的时间最长?	推荐类	事实类
林志颖多少年出生啊??	事实类	事实类
音乐你们都是到哪里听的啊	推荐类	枚举类
具说萧亚轩他以前唱的有些歌曲都不适合她唱?	是非类	评价类
周杰伦的《爱我别走》的歌词??	需求类	需求类
BOBO有哪几张专辑?	事实类	枚举类
谁知道周杰伦的专辑都叫什么?	事实类	枚举类
<越人歌>是什么人写的?	事实类	事实类
刘德华演唱会今年在哪?	事实类	事实类
有谁知道周杰伦的新专集	事实类	事实类
阿信最大的魅力?	评价类	评价类
什么时候徐子祥才能成为明星?	评价类	评价类
哪里可以听非主流歌?	需求类	推荐类
CK的《他不知道》的歌词谁知道?	需求类	需求类
还有没有人知道东方神起的一些中文歌曲?	枚举类	枚举类
求几首周杰伦的歌词!!	需求类	需求类
我想知道这首歌的歌词的意思	描述类	描述类
谁告诉我星星谁爱你的歌词是什么???	需求类	需求类
谁有比较伤感的歌词	推荐类	推荐类
喜欢摇滚的多吗?	是非类	评价类
东方神起的所有成员真实的身高体重是多少?	枚举类	枚举类
有谁知道周星驰多大?	事实类	事实类
谁有比较Hi的 舞曲啊 ?	推荐类	推荐类
哪个网站有中国流行歌曲的排行榜阿?	需求类	需求类
大家喜欢听什么样的歌曲·是感动的·还是伤感的·还是··	评价类	推荐类
听歌的乐趣在于什么?欣赏他的歌词?	评价类	评价类
说好的幸福呢这首歌的MV讲的是什么故事啊	描述类	描述类
怎么抓MV的图?3秒的.	方法类	方法类
谁有节奏感强的音乐	推荐类	推荐类
听哪种歌曲会有幸福的感觉?	推荐类	推荐类
哪里有比较好听的歌哦?	推荐类	推荐类
世界上有最有感情的曲子?	推荐类	推荐类
谁知道悲伤这首歌的连接	需求类	需求类
在哪找QQ音乐	需求类	需求类
我们都会错谁唱的?	事实类	事实类
jay世界巡回演唱会到过哪里	枚举类	枚举类
王力宏最近的一场演唱会叫什么?	事实类	事实类
BEYOND的日本演唱会在哪找?	需求类	需求类
我很喜欢潘玮柏,最近他在干什么啊?	描述类	描述类
飞轮海里面有哪写人	枚举类	枚举类
谁能给我《爱的翅膀》的歌词	需求类	需求类
啊有动感点的歌啊.?有多少要多少哦.!	推荐类	推荐类
有多少歌手唱海豚音唱的好?	推荐类	事实类
谁的蓝调最好听?	推荐类	推荐类
谁知道杨丞琳的父母叫什么名?	枚举类	事实类
JAY到底喜欢谁呢?	推荐类	事实类
《寻找周杰伦》这部电影讲的是什么?	描述类	描述类
大家觉得Declan的哪张专辑最好听?	评价类	推荐类
最近谁有新专辑啊	枚举类	枚举类
SJ三辑啥时候出来吖?	事实类	事实类
上海哪里有买东方神起的东西?	需求类	需求类
什么样的音乐使人轻松	推荐类	评价类
《梁祝》的词曲作者?	事实类	事实类
现在有什么人出了新专辑啊,谁来告诉我一下啊?	枚举类	枚举类
宝儿出过几张专集?	事实类	事实类
现在有哪些比较流行的歌手?	推荐类	推荐类
刘德华在影视上因为哪部电影出名的?	事实类	事实类
中国有嘻哈乐么?	是非类	是非类
小沈阳是以什么出名的?	原因类	原因类
蔡旻佑唱的 我可以 歌词谁知道 ?	需求类	需求类
蔡依林全国是女歌手中最红的吗??	是非类	评价类
娱乐圈里有真正的友谊吗~?	评价类	是非类
有谁知道得到你的人却得不到你的心 的歌词	需求类	需求类
张杰有多喜欢谢娜?	评价类	评价类
周杰伦 春晚第几?	事实类	事实类
今天的春晚会来谁哦?	枚举类	事实类
周杰伦上过那几年的春晚	事实类	枚举类
有没有好看的男明星?	推荐类	推荐类
我要成明星!谁能帮我?	评价类	方法类
娱乐圈是个复杂的社会地位?	是非类	评价类
陈冠希现在在哪个国家?	事实类	事实类
刘德华哪年生啊?	事实类	事实类
现在在哪个网站或者哪个工具听歌比较好?	需求类	推荐类
工作的时间听什么音乐最好啊?	推荐类	推荐类
我爱记歌词里的王滔是不是要离开我爱记歌词了?	是非类	是非类
《说好的幸福呢》歌词是谁写的	事实类	事实类
原来我不帅的背景曲是?	事实类	事实类
一千年以后这首歌谁唱的	事实类	事实类
JAY的专辑多会发行?	事实类	事实类
JJ有那几张专辑?	事实类	枚举类
谁知道胡歌拍的连续剧都有哪些。那部最好看?	枚举类	推荐类
beyond谁唱歌好听啊	推荐类	推荐类
明星一般都做什么了?	描述类	枚举类
明星算什么东西?	评价类	描述类
罗志祥《敢不敢》的歌词是什么?	需求类	需求类
王菲是哪个公司的??	事实类	事实类
这是谁啊?给点资料	描述类	描述类
谁有黑色幽默的lrc歌词?用回答问题的方式告诉我好吗?	需求类	需求类
谁知道滨崎步的最新专辑是什么?里面有几首歌?	枚举类	事实类
CK的歌去哪找	需求类	需求类
怎么样知道网络歌的地址?	方法类	方法类
罗志祥的博客是多少?怎么那么多人冒充	事实类	需求类
谁能告诉我点明星的资料 谁的都行	描述类	描述类
周杰伦和张学友你喜欢谁多一点?	评价类	评价类
周杰伦的新歌好不好听?	评价类	评价类
飞轮海有几名成员?叫什么?	枚举类	事实类
有谁有sara版的命运的歌词,不是rain的那个	需求类	需求类
求这首歌的歌词?	需求类	需求类
谁有一些比较伤感的歌词?	推荐类	推荐类
BEYOND的这个演唱会叫什么?	事实类	事实类
何洁在哪开演唱会	事实类	枚举类
活埋这首歌谁唱的	事实类	事实类
林依晨是哪里人?具体一点!	事实类	事实类
谁将是王力宏的幸福女友?	事实类	推荐类
何炅的真实年龄是多少岁?不要给我虚假的!	事实类	事实类
最近有什么好看的偶像距	推荐类	推荐类
Rain出道几年了?	事实类	事实类
我的小白的歌词是什么?	需求类	事实类
在论坛的哪儿找歌	方法类	需求类
着名的哥特乐队都有哪些?	推荐类	推荐类
周杰伦的电影到哪找啊?	需求类	需求类
请问有没有个专业一点的伴奏网站?	需求类	推荐类
谁有(后悔的来找我)这首歌的歌词?	需求类	需求类
在哪可以搜到好听的歌	需求类	推荐类
周杰伦的歌,我身边的人都很喜欢,而我更欣赏歌中所唱的词,那么你们认为哪十句是感动人的歌词?	推荐类	推荐类
哪个男星的歌好听	推荐类	推荐类
钢琴是谁最早发明的?	事实类	事实类
周杰伦最爱吃什么???	枚举类	事实类
QQ音乐哪个版本点击右键可以查找自己播放列表里的歌曲?	事实类	事实类
到底有没有《蓝宫调》这个专辑?	是非类	是非类
QQ音乐的歌曲能下载多少?	事实类	事实类
有谁知道唱这首歌的歌手?	事实类	事实类
为什么很多好听的歌、QQ音乐上都没有?	原因类	原因类
噼里啪啦的歌词谁有啊??或者网址也可以啊。。!	需求类	需求类
QQ音乐在哪里设置东西	方法类	方法类
谁有对岸的婚礼 MV或MTV?	需求类	需求类
[谁]知道[会唿吸的痛]的歌词...??	需求类	需求类
JAY的新专集怎么样啊	评价类	评价类
知道最近出什么新专集么?	枚举类	事实类
刘德华的巡回演唱会这一站在哪?	事实类	事实类
JAY的世界巡回演唱会有哪几站	枚举类	枚举类
jay的出生地是Where?	事实类	事实类
林俊杰在2008年在哪有演唱会?	事实类	枚举类
谁能告诉个可以看演唱会的网站?	需求类	需求类
最近哪里开演唱会,在哪?谁?谢谢知道的告诉我	枚举类	枚举类
SHE今年还会在哪里开演唱会?	事实类	枚举类
周杰伦写的一本书叫什么?	事实类	事实类
RAIN--有着多少的粉丝?	事实类	事实类
周杰伦的妈妈叫啥?	事实类	事实类
请问蓝白慢摇吧的开场三叫什么名字?	事实类	事实类
有没有一种爱让人不流泪谁唱的?	推荐类	事实类
BEYOND的历史谁告诉我啊?	描述类	描述类
谁有张杰新专辑	需求类	需求类
杰伦的新电影叫什么?	事实类	事实类
请问谁有《最劲爆的DJ》???	需求类	需求类
哪里可以了解到最新的音乐?	需求类	需求类
哪个网站可以把本地的音乐传到上去	需求类	需求类
谢霆锋新专辑到底好久出来哦?	事实类	事实类
王力宏的<改变自己>销量多少?	事实类	事实类
YOU 黑GIRL OOXX MP3的地址吗 ?	需求类	需求类
全球禁曲黑色星期天的歌词有人知道吗?	需求类	需求类
谁能告诉我<电影不能说的秘密>里的钢琴曲?	事实类	需求类
钢琴曲《彩云追月》是几级的曲子	事实类	事实类
你最希望JAY的下张专辑是什么风格的?	推荐类	评价类
大家有没有好听歌 ,可以告诉我吗?	推荐类	推荐类
哪韩国组合最好呢?	推荐类	推荐类
有多少人喜欢韩国?	事实类	事实类
任贤齐的 花好月圆 的歌词是什么	需求类	需求类
2009年周杰伦发什么专辑?	事实类	枚举类
韩国谁的歌曲好听?	推荐类	推荐类
台湾有多少男歌手?	事实类	事实类
你喜欢那个歌手的歌曲?	推荐类	推荐类
有谁知道刘德华是哪的人?	事实类	事实类
现在有多少人喜欢 许嵩?	事实类	事实类
下载伴奏的网址都有什么啊?	推荐类	需求类
女歌手唱歌最好听的是谁	推荐类	推荐类
爱情的娱乐圈好累?	评价类	评价类
周杰伦的《稻香》是为谁而写的?	事实类	事实类
谁能给我一颗心的距离的歌词?谢谢!	需求类	需求类
张杰吸引人的地方在哪?	评价类	评价类
四大天王有哪四个?	枚举类	枚举类
许姓的歌星有多少.列表出来.谢谢越全越好	枚举类	枚举类
刘德华是中国最红的歌星吗?	评价类	评价类
对陈冠希的看法?你认为呢?	评价类	评价类
周笔畅哪点你喜欢	评价类	评价类
谁能帮我找到这个音乐的名字	事实类	事实类
"""怎样的我才能让你更想念""是哪首歌的歌词啊?"	事实类	事实类
刘若英出过几张专辑	事实类	事实类
谁有战士的后代的前面的鼓点伴奏?	需求类	需求类
lalaladj请问他的歌词是什么呢	需求类	事实类
08年潘玮柏会会出专辑?	事实类	是非类
周杰伦出国几张专辑啊?	事实类	事实类
谁有<<改变自己>>专辑	需求类	需求类
在哪里可以买到SJ的专辑	需求类	需求类
哪里可以买到SJ-M的专辑?	需求类	需求类
请问歌手郑源是哪里人?	事实类	事实类
周杰伦的MV哪个拍的最好?	推荐类	推荐类
请问一下BEYOND原来有多少人?	事实类	事实类
哪里有关于明星的书	需求类	需求类
请列出李玟的专辑介绍?	描述类	描述类
谁有BOBO的所有歌的歌词?	需求类	需求类
滨崎步出道几年了?	事实类	事实类
你们喜欢滨崎步的哪里?	评价类	评价类
谁有BOBO组合的专辑呢?	需求类	需求类
还有人喜欢听张学友的个吗?	评价类	评价类
beyond三个人什么时候解散的啊?	事实类	事实类
谁有《现在的他对你好吗》的歌词 谢谢	需求类	需求类
觉得哪句歌词最让人感动?	推荐类	推荐类
韩国近几年有什么好玩的电视剧吗?	推荐类	推荐类
谁有 HEY! 的LRC歌词?	需求类	需求类
请问谁有歌曲《大支diss》的歌词呢!?	需求类	需求类
情醉的歌词是什么?	需求类	事实类
星星说爱你的歌词是什么?	需求类	需求类
谁知道“全世界的人都知道”的歌词?	需求类	需求类
歌词中有一个人匆匆忙忙过一生的歌词是?	事实类	事实类
BEYOND是最棒的乐队吗	评价类	评价类
BEYOND乐队原来有几个人啊?	事实类	事实类
Vae亲笔签名专辑多少元一张?	事实类	事实类
王力宏演过电影或者是电视剧吗?	枚举类	是非类
请问歌曲 活埋 的正确的歌词是什么?	需求类	事实类
怎样K歌问题	方法类	方法类
东方神起在中是韩国哪里人?	事实类	事实类
问RAIN 身高是多少>呢?	事实类	事实类
喜欢周杰伦哪点?	评价类	评价类
rain出道几年了?	事实类	事实类
目前是BEYOND的歌迷多还是JAY的歌迷多?	评价类	评价类
那里有纯女声的背景音乐?	需求类	需求类
有哪些歌曲的MV比较好看的?	推荐类	推荐类
请问 : 我爱你的歌词是什么 ?	需求类	需求类
谁知道JAY的图网?	需求类	需求类
罗志祥女朋友叫什么?	事实类	事实类
谁能提供欢快歌曲吖。。	推荐类	推荐类
哪里可以学翻唱后期制作的	需求类	需求类
vae这首歌的歌词?	需求类	事实类
《不知道自己明天该往那走》这是那一首歌的歌词呢?	事实类	事实类
有没比较长的钢琴独奏曲?	推荐类	推荐类
哪里有比较好的钢琴网站?	推荐类	推荐类
一架便宜点的二手钢琴卖多少钱?	事实类	事实类
林俊杰有公开自己的女友吗? 是谁呀?	事实类	事实类
有米简单的曲子来练吉他啊 ?	推荐类	推荐类
你们喜欢周杰伦吗?请说说喜欢和不喜欢的理由。	评价类	评价类
RAIN和周杰伦哪个更火	评价类	评价类
从QQ音乐上下载的歌是什么格式的	事实类	事实类
韩国有什么好电视睇啊	推荐类	推荐类
大家最喜欢的日本歌是什么?	推荐类	推荐类
QQ音乐可以记录歌曲,到任何地方都可以听吗?	是非类	是非类
和许嵩合唱‘浅唱’的女孩叫什么 ?	事实类	事实类
谁知道有些边哭边唱的歌例如《泪的告白》等类的。?	推荐类	推荐类
哪个英文歌手唱的歌很好听啊?	推荐类	推荐类
简单的浪漫歌词谁有?	需求类	需求类
有人喜欢JAY的退后吗?	评价类	评价类
最近JAY要去哪里开个人演唱会??	事实类	事实类
神起的最新演唱会在哪`	事实类	事实类
有没有可以看周杰伦演唱会的网站啊?	需求类	需求类
6月23号合肥张学友演唱会多少钱一张票啊?	事实类	事实类
周杰伦的现场演唱会在哪个网站看?	需求类	需求类
飞轮海现在在哪里开演唱会呢	事实类	事实类
beyond的号歌有几个啊?	事实类	事实类
飞轮海拍过什么片	枚举类	枚举类
刘德华住在哪里?	事实类	事实类
SHE 和 飞轮海谁比较红?	评价类	评价类
飞轮海组合有多少个人?	事实类	事实类
飞轮海的占有是什么时候写的	事实类	事实类
在什么网站里可以给飞轮海投票?	需求类	需求类
谁知道HOT的全部专辑????	枚举类	枚举类
哪里可以下载好听的说唱或最流行的歌曲(网站)	需求类	需求类
BEYOND是几人组合?	事实类	事实类
最近都有什么好看的歌推荐	推荐类	推荐类
杨丞琳是八几年的	事实类	事实类
我想要张杰的CD哪有正版	需求类	需求类
vae和别人合作的有多少歌?	事实类	事实类
谁有Jay的完美介绍```	描述类	描述类
JAY和谁最配`?	推荐类	推荐类
棒棒堂的演唱会在哪里开的?	事实类	事实类
棒棒堂最近出了什么唱片吖?	事实类	枚举类
棒棒堂谁最会跳舞	推荐类	推荐类
谁唱得歌比较好听?男的	推荐类	推荐类
哪里有劲爆的DJ歌曲?	需求类	推荐类
音乐之都在哪里?	事实类	枚举类
孙燕姿几张专辑?	事实类	事实类
谁知道孙燕姿的悲伤歌?	推荐类	推荐类
周杰伦新专辑《魔杰座》最新销量是多少	事实类	事实类
谁知道Jay何时再出下一张个人专辑阿,?	事实类	事实类
到录音棚录歌要多少钱呀?	事实类	事实类
我想知道 难道爱一个人有错吗 的歌词	需求类	需求类
钢琴曲的童话有谁能教我	需求类	方法类
哪里有需要演出的活动。。。。	推荐类	需求类
东方神起和SJ谁厉害些?	评价类	评价类
哪里有卖sj的全部CD	需求类	需求类
SJ从谁开始谁结束	枚举类	事实类
谁那有许嵩的歌的地址	需求类	需求类
有井柏然的最新专集吗?	需求类	是非类
JJ新专辑的主要风格是什么	事实类	事实类
飞轮海的《越来越爱》买多少钱?	事实类	事实类
林俊杰的年说如是多少?	事实类	事实类
谁知道<<明天过后>>歌词?	需求类	需求类
最近的什么专辑比较好听。。?	推荐类	推荐类
至上励合多会儿出新专辑?	事实类	事实类
中国有像superjunior这样的组合吗??	是非类	是非类
谁的日文歌最好听啊?	推荐类	推荐类
谁有任贤齐07年5月份的演唱会的专辑	需求类	需求类
有谁知道任贤齐我的偶像最近有什么新的信息啊 ???	描述类	描述类
近期谁在北京开演唱会了?	枚举类	枚举类
周杰伦的《我好忙》是什么时间出的	事实类	事实类
宝儿的“永恒”哪找?	需求类	需求类
谁有非主流音乐“PEERLESS”的歌词	需求类	需求类
现在有哪些欧美的歌手的歌好听啊	推荐类	推荐类
有谁知道刘德华生日多少?	事实类	事实类
SHE在2007年北京音乐典礼上的了什么奖?	事实类	事实类
谁知道经典的演唱会	推荐类	推荐类
谁知道蔡依林有没qq是多少?	事实类	需求类
在黑涩会鈡谁最大?	事实类	事实类
黑涩会美眉有几位?	事实类	事实类
娱乐圈最新动态可以在哪里看?	需求类	需求类
谁知道棒棒堂有几个人???	事实类	事实类
有没有人知道伤了你的心我好伤心的歌词	需求类	事实类
时间仿佛可以停了```是哪首歌的歌词?	事实类	事实类
张杰专辑明天过后多少钱一张	事实类	事实类
李连杰出身哪里	事实类	事实类
熊汝霖现在干什么呢 出专辑了吗	描述类	描述类
中国一共有多少名明星?	事实类	事实类
有多少你喜欢安七炫	评价类	事实类
周杰伦是唱哪首歌开始走红的	事实类	事实类
超级玛丽的rap版谁给个连接?	需求类	需求类
你喜欢看怎样的的明星?	推荐类	推荐类
如何下载MP4格式的歌曲	方法类	方法类
如果还有明天这首歌最后说唱部分的歌词是什么	需求类	需求类
大家看下这是什么歌的歌词,或者它不是歌词?	是非类	事实类
123木头人有谁有它的歌词啊我想要他的`歌词	需求类	需求类
谁知道英文歌 I am is you 的歌词,	需求类	需求类
什么都不要对我说的歌词是什么?	需求类	事实类
有谁知道随心所欲的完整歌词?	需求类	需求类
谁有张栋梁的照片?给我几张?	需求类	需求类
张靓颖是哪的人	事实类	事实类
刘德华最近有什么新电影啊???	事实类	事实类
谁知道刘德华家在哪	事实类	事实类
小沈阳女儿叫什么 ?	事实类	事实类
哪些歌是罗志祥作的曲?	枚举类	枚举类
JAY的歌曲有多少首?	事实类	事实类
郑源现在有多少岁?	事实类	事实类
阿信的新歌哪个是广告曲?	事实类	事实类
周杰伦的mv哪个最浪漫?	推荐类	推荐类
五月天阿信出过什么书?	事实类	枚举类
什么样的明星才算是大牌的!	推荐类	评价类
谁有好听的慢摇歌曲,或者免费试听的网站?	需求类	推荐类
如何查找最新歌曲?	方法类	方法类
滨崎步的出道十年纪念专辑哩有哪些曲?	枚举类	枚举类
周杰伦几月份出新专辑?	事实类	事实类
jay几月份再出新专集?	事实类	事实类
王心凌《第一次爱得人》的歌词是什么?	需求类	需求类
VITAS的专辑`哪个见过哪有卖的!	需求类	需求类
在哪个网站下整张专辑会比较好	需求类	推荐类
谁有亲爱的,那不是爱情的歌词?	需求类	需求类
谁知道哪有新英雄本色{国语}的?	需求类	需求类
jay真正的帅吗??	评价类	评价类
谁能给我she“我爱你”的完整歌词	需求类	需求类
谁有NA NA 唱的 LONELY 歌词?	需求类	需求类
(爱你一次就想你一生)的歌词是什么	需求类	需求类
钢琴四级的曲目?	推荐类	枚举类
beyond是亚洲最有成就力的乐队吗?	评价类	评价类
《我说我爱你》这歌好听吗?	评价类	评价类
今年元旦深圳有什么演唱会?	枚举类	枚举类
周杰伦与王力宏谁更有实力?	评价类	评价类
哪个网站能K歌	需求类	推荐类
谁能告诉我王力宏的所有专辑	枚举类	枚举类
周董的什么电影最好看?	推荐类	推荐类
Rian和周董谁比较帅	评价类	评价类
谁知道周董的最新内容.	枚举类	描述类
谁有许巍老婆的照片?	需求类	需求类
最近谁的歌曲比较受人喜欢?	推荐类	推荐类
东方神起里有几个成员?	事实类	事实类
郑源出生在哪里?	事实类	事实类
she的芳龄是多少?	枚举类	事实类
在哪下说唱的伴奏!!	需求类	需求类
卓文萱吧在哪里?	事实类	事实类
哪里的孙燕姿的歌迷最多呢?	事实类	事实类
谁有深情点的歌给我几个	推荐类	推荐类
SJ-M 5只唱的《至少还有你》韩文版的歌词的罗马拼音~!?	需求类	事实类
谁能告诉我神话中的Eric到底多大了?	事实类	事实类
谁能给我vae新专辑《认错》的歌词?	需求类	需求类
我想学钢琴 ,大概多少钱一个月啊	事实类	事实类
谁有好的乐队开场曲	推荐类	推荐类
钢琴摆在家里的什么位置最合适?	推荐类	推荐类
哪里学小提琴比较便宜?	推荐类	推荐类
哪有较好的古典吉他独奏曲谱	推荐类	需求类
钢琴的级别多少?	事实类	事实类
请问:哪里学习钢琴价格比较实惠??	推荐类	推荐类
那里能找到伤感的歌曲?	推荐类	推荐类
怎么样才能听到好听的歌曲啊	方法类	方法类
陈楚生出了好几首新歌,是不是要出专辑了?	是非类	是非类
林俊杰他的女朋友叫什么名字?	事实类	事实类
唐禹哲《D新引力》里的新歌什么时候能听	事实类	事实类
只知道几局歌词不知道歌名怎么办?可怜我爱你那么多....你却忍心伤害我...	事实类	方法类
JJ还有多久出新专集?	事实类	事实类
我的QQ空间问题解决了,新问题又来了,QQ音乐也进不去了,唉!	原因类	原因类
在哪里能买到至上励合的图片	需求类	需求类
谁有不够成熟这首歌的歌词?	需求类	需求类
beyond和黄家驹哪个更出名	评价类	评价类
黄家驹几岁死了?	事实类	事实类
有谁知道刘德华这次的演唱会都在什么地方?	事实类	枚举类
林俊杰演唱会是那里举办的 ?	事实类	事实类
东方神气在南京演唱会 门票多少	事实类	事实类
谁知道王力宏成都演唱会网址	需求类	需求类
谁能告诉我东方神起的韩国网站	需求类	需求类
有谁能给我几张东方神起的图片	需求类	需求类
张杰有多帅?	评价类	评价类
《北京欢迎你》里面怎么没有刘德华?	原因类	原因类
请问大家认为刘德华帅在哪里?	评价类	评价类
周杰伦的歌HI 暴吗?	评价类	评价类
谁有一些飞轮海的图片啊?	需求类	需求类
哪里有卖林俊杰那种样子的格子衣服?	需求类	需求类
谁能给几个听蓝调的网站?	需求类	推荐类
有谁有早期的Beyond的专集!	需求类	需求类
许巍的哪一张专辑最好听	推荐类	推荐类
周杰伦和东方神起那个更出名?	评价类	评价类
东方神起五人分别多少岁?	枚举类	枚举类
谁知道 周星驰的 电话号??	事实类	事实类
有谁比JAY厉害	推荐类	推荐类
请问谁有超嗨的嗨曲..	推荐类	推荐类
棒棒堂除了上<模范棒棒堂>外还有上什么节目??	枚举类	枚举类
谁能给我周杰伦唱的青花瓷的歌词啊!	需求类	需求类
B WHAT U WANNA的歌词是什么	需求类	需求类
音乐是从哪来的啊?	事实类	事实类
JJ所有的歌 一共有多少	枚举类	事实类
艾薇儿有参加什么电影啊 ??	事实类	枚举类
最近孙燕姿有什么新的消息?	描述类	描述类
你们谁知道高耀太的生日?	事实类	事实类
求助《夜的第七章》中间有段jay唱的什么?	事实类	事实类
周杰伦的歌是不是最好听?	评价类	评价类
请问《一天一天》的钢琴谱有没有不是四手联弹的?	是非类	是非类
你可以把你那彩云追月的合唱谱给我吗?	需求类	需求类
sj-m现在在哪里?	事实类	事实类
东方神起和SJ谁更红	评价类	评价类
为什么现在好听的歌越来越少了呢?	原因类	原因类
林俊杰的出生日期,是多少?	事实类	事实类
好看的影视介绍?	推荐类	推荐类
RAIN和张佑赫水是舞王?	评价类	是非类
任贤齐和周杰伦谁帅	评价类	评价类
跨金演唱会有多少位歌手和多少位观众?	事实类	事实类
哪里能买到东方神起美国写真?	需求类	需求类
世界上有多少歌手?	事实类	事实类
Vae许嵩的《有何不可》歌词?	需求类	需求类
周杰伦唱歌的风格主要是什么?	事实类	描述类
Jay有多少难听的歌?	事实类	事实类
小齐最近有什么新专辑没有?	事实类	事实类
光良的出生地是哪国?	事实类	事实类
韩庚在韩国住在哪里?	事实类	事实类
大家都喜欢林俊杰的哪里?!	评价类	评价类
高耀太在韩国有多红?	评价类	评价类
bobo组合现在的人气多少???	事实类	事实类
有没有爱你爱到死的歌词??	需求类	需求类
张杰-明天过后-是他的第几张专辑?	事实类	事实类
张杰和谢娜各有多少岁?	枚举类	枚举类
2009春晚有什么值得期待的?	评价类	推荐类
2009年春节晚会谁最红	推荐类	推荐类
马天宇他多大了?	事实类	事实类
周杰伦的家住在哪	事实类	事实类
至上励合几时正式成立啊....	事实类	事实类
最难学的乐器是什么	推荐类	推荐类
有谁认识这种乐器?	事实类	描述类
有两年的时间,学什么民族乐器比较好?	推荐类	推荐类
世界上有多少名明星	事实类	事实类
各明星的qq是多少	枚举类	需求类
为什么现在的孩子这么喜欢周杰伦?	原因类	原因类
音乐可以分为几类	事实类	枚举类
Super Junior《幸福》是翻唱H.O.T的哪一首歌?	事实类	事实类
有一个五人组合,里面有一个是韩国人来的!请问那个组合叫什么名字?	事实类	事实类
《爱我的请过来》这首的中文歌词是什么?	需求类	需求类
我爱的人已经飞走了,爱我的人他还没有来到,是那首歌的歌词?	事实类	事实类
JAY多会再发专辑?	事实类	事实类
哪有卖正版专辑的?	需求类	需求类
张韶涵新专集怎么样???	评价类	评价类
我的专辑 什么才能上传```可以看的呢?	方法类	方法类
super junior-M的最新专辑是什么时候发行的?	事实类	事实类
唱<你是灰色的>的傅颖几岁了?	事实类	事实类
JAY的歌曲里你最喜欢那些???	推荐类	推荐类
哪个网站上有好听的轻音乐?	需求类	推荐类
谁有MJ30周年演唱会	需求类	需求类
哪有卖Rain的演唱会DVD/VCD?	需求类	需求类
谁找到得东方神起演唱会完整视频?	需求类	需求类
周杰伦的我不配和不能说的秘密哪首歌好听?	评价类	推荐类
最近与人和唱的新歌,韩红的?	推荐类	枚举类
beyond最辉煌的是哪几年	事实类	推荐类
《不能说的秘密》里面的女主角是不是在JAY的MV里出现过啊?	是非类	是非类
周杰伦和林俊杰谁更厉害!谁更红!	评价类	评价类
一个人可以同时喜欢两个明星吗?	是非类	是非类
飞轮海的孤单摩天轮的歌词是什么	需求类	需求类
谁有JAY的最新单曲啊 给我发下	需求类	需求类
刘德华的地址是什么要具体的?	事实类	事实类
寻找蔡妍的幸福的眼泪歌词?	需求类	需求类
“sorry”的歌词在那里才能找到呢?	需求类	需求类
小猪是谁啊???罗志祥吗???	是非类	事实类
谁有卡农的简谱吖?	需求类	需求类
张韶涵个人网站,博客,论坛是什么?	事实类	事实类
张韶涵的什么歌你最喜欢?	推荐类	推荐类
最近有没有哪个的唱片	枚举类	枚举类
你觉得哪个唱片公司最强大?	推荐类	推荐类
张学友的哪首歌唱的最有味道?	推荐类	推荐类
小虎队成立了几年?	事实类	事实类
"""多爱我一天:""的歌词是什么 啊?"	需求类	需求类
你怎么舍得我难过的歌词是什么.	需求类	事实类
有谁知道怀念过去的歌词	需求类	需求类
谁有这首歌的歌词?如下	需求类	需求类
现在有最新的韩曲吗?	枚举类	推荐类
现在哪些乐队的歌好听啊???	推荐类	推荐类
李宇春的(2009Why me)演唱会都在哪几个城市?	事实类	枚举类
Jay元旦的演唱会在深圳哪里举行的可能性大点?	推荐类	事实类
何洁在哪里开跨年縯唱会?!	事实类	事实类
假如让我说下去的歌词是什么?	需求类	事实类
何炅的专辑在哪里能买到?	需求类	需求类
谁知道何炅现在住在哪?	事实类	事实类
请问周杰伦家在哪	事实类	事实类
jay出道以来你们最喜欢的事哪几首歌`	推荐类	推荐类
BY2组合是属于港台还是属于大陆的?	事实类	是非类
有谁知道吉他谱曲的好点的网站	需求类	推荐类
谁知道新歌(小酒窝)的歌词!!???	需求类	需求类
最让你感动的首情歌是?	推荐类	推荐类
有谁知道 阿姆唱的hellbound的歌词?急	需求类	需求类
今年流行什么歌!谁的歌最受欢迎	推荐类	推荐类
谁能帮我谱一下曲?	需求类	需求类
请问、嗨点、的流行歌、有么	推荐类	推荐类
为什么心情烦躁的时候听听音乐,会感觉到很轻松?	原因类	原因类
"求""即使知道要见面""伴奏下载地址`."	需求类	需求类
一般较好的吉他价位在多少	事实类	事实类
谁能给我推荐一些好看的MV?	推荐类	推荐类
有啥好看的新MV?	推荐类	推荐类
小猪罗志祥出过几张专辑?	事实类	事实类
谁知道在周杰伦的那首《外婆》和杰伦对唱的那女孩是谁?	事实类	事实类
五月天和SHE唱的歌是?	事实类	事实类
谁知道张杰的<化学反应>的视频地址啊?	需求类	需求类
谁能给我VAE多余的解释的歌词?	需求类	需求类
谁能告诉我《安静了》的歌词	需求类	需求类
<那个女孩对我说>歌词是什么?	需求类	事实类
快乐男声每个人的EP里都有哪些歌	枚举类	枚举类
哪有吉他教学视频啊	需求类	需求类
现在市场上一台yamaha的钢琴多少钱?	事实类	事实类
苏醒和陈楚生谁会是冠军?	评价类	评价类
JJ的最新近况是啥?	描述类	描述类
有谁知道炎亚纶家住在哪	事实类	事实类
秀秀几岁进SM公司?	事实类	事实类
sara是那里人?	事实类	事实类
钢琴级别达到多少级可以弹《梦中的婚礼》?	事实类	事实类
周杰伦目前几岁	事实类	事实类
火花 这首歌的歌词是什么	需求类	需求类
QQ音乐列表里的音乐为什么位置变了,有的在上面有的在下面,出错的不多,只有那么几首。有没有可能是我的操作问题,不小心点哪个键了?	原因类	原因类
谁能说下JAY的几张专集的名字?	枚举类	枚举类
谁有至上励合的海报?	需求类	需求类
最新的QQ音乐在哪里上传啊。。	需求类	需求类
《玫瑰花的葬礼》为谁而唱	事实类	事实类
周杰伦和哪些人合唱过?	枚举类	枚举类
中国有什么公司培养艺人	枚举类	枚举类
说说自己喜欢的艺人??	评价类	推荐类
张韶涵和王心凌,更喜欢谁?	评价类	评价类
谁给我说一下黄家驹的海阔天空的歌词	需求类	需求类
你对超女的印象是什么?	评价类	评价类
周杰伦下站演唱会是哪里?	事实类	事实类
想知道一下09年各个人演唱会的时间安排	描述类	枚举类
9月13号的SM家族上海演唱会,SuperJunior是以13个人的形式出现么?	是非类	是非类
周杰伦今年世界巡回演唱会都去什么地方?	事实类	枚举类
Avril最近在哪国开的演唱会?	事实类	事实类
jay在成都开演唱会是哪里主办的?	事实类	事实类
亚洲最红的明星是东方神起吗?	评价类	评价类
所有<飞轮海>的电影或电视剧有哪些?	枚举类	枚举类
潘玮柏多少斤啊??	事实类	事实类
谁知道潘玮柏最近有什么新动态?	枚举类	描述类
周杰伦受欢迎还是刘德华?	评价类	评价类
刘德华的家乡在哪	事实类	事实类
我最喜欢的明星是刘德华,请问刘德华第一张专辑叫什么	事实类	事实类
飞轮海每个人各有多少粉丝	事实类	枚举类
谁知道刘亦菲是哪里人?	事实类	事实类
周杰伦没出名之前他是做什么的?	事实类	事实类
周杰伦唱的歌有多少	事实类	事实类
棒棒堂是3月几号到广州??	事实类	事实类
林俊杰现在有多少钱?	事实类	事实类
金莎和谁最配?	推荐类	推荐类
有没有海豚音的歌曲,,地址?!!	需求类	需求类
谁能帮我做曲.	需求类	需求类
BEYOND你理解吗?	评价类	评价类
周杰伦新专集能在哪个网站上下载	推荐类	需求类
"谁有 ""明天以后"" 的粤语歌词啊?"	需求类	需求类
谁有女声版的伤心情歌	需求类	需求类
林心如拍过什么3J片.?	枚举类	枚举类
东方神起谁长的最像女生	推荐类	推荐类
怎么可以找到QCC里的音乐?	方法类	方法类
JAY今年多少岁勒?!	事实类	事实类
金沙和林俊杰合作的新单曲叫什么?	事实类	事实类
歌的旋律在哪找?	需求类	需求类
棒棒堂拍过咩电视剧?	是非类	枚举类
韩庚、基范.比较喜欢哪个?	评价类	评价类
i for you的歌词有吗?	需求类	需求类
艾薇儿有没有拍过电影?	是非类	是非类
中国唱片销量最高的专辑?	事实类	事实类
周杰伦读了几年书啊 ?	事实类	事实类
俞思远什么时候出第四张专辑?	事实类	事实类
谁能给我一下BARBIE GIRL这首歌的歌词?	需求类	需求类
SJ有主持过什么节目?	枚举类	枚举类
super junior的第三辑价钱大约是多少?	事实类	事实类
东方神起究竟是日本还是韩国的?	事实类	事实类
飞轮海捐多少	事实类	事实类
林俊杰的第一部电影叫什么名??	事实类	事实类
你认为杰伦的经典歌词是哪句?	推荐类	推荐类
杰伦《不能说的秘密》不能说的是?	事实类	评价类
至上励合的人都是从哪来的?	事实类	枚举类
请问: 啥叫帅哥.? 啥叫美女.?	评价类	描述类
周杰伦和任贤齐谁帅.?	评价类	评价类
有多少人期待刘德华的游龙戏凤?	事实类	事实类
《火》这首歌是谁唱的?就是天天向上经常放的那首	事实类	事实类
怎样才能听到更好听的歌曲?	方法类	方法类
羽泉是哪里人?	事实类	事实类
谁有蔡妍两个人的中文版?	需求类	需求类
请问蔡妍是那里人	事实类	事实类
哪里有 我就是非主流 这首歌的歌词	需求类	需求类
什么牌子的电贝司好	推荐类	推荐类
(即使知道要见面) 的歌曲谁知道?	需求类	事实类
金城武是哪里的?	事实类	事实类
唱北京欢迎你这歌共有多少歌手???	事实类	事实类
周杰伦和刘德华谁才是天王?	评价类	评价类
小沈阳年龄多大?	事实类	事实类
08年BOBO都拿了哪些奖??	枚举类	枚举类
乔任梁总共得过些什么奖?	枚举类	枚举类
Vae 许嵩唱的<有何不可>是为哪个唱的?	事实类	事实类
JAY,爲哪些歌手写过歌,,?	事实类	枚举类
JAY的哪场演唱会最经典?	推荐类	推荐类
杜德伟从出道到现在都在什么地方举办过演唱会	枚举类	枚举类
当歌手需要的是什么?	事实类	评价类
蔡旻佑-双截棍抒情版 谁能传给我?QQ114561875	需求类	需求类
世界上最难听的歌出了没?	是非类	是非类
黑涩会的MM有多少个哦?	事实类	事实类
棒棒堂和黑涩会谁更加出名?	评价类	评价类
黑涩会MM谁长的好?	评价类	推荐类
黑涩会美眉有多少成员?	事实类	事实类
韩庚的组合叫什么?	事实类	事实类
韩庚在那个组合?	事实类	事实类
韩庚是韩国哪里的?	事实类	事实类
最近有没有棒棒堂的演出?	是非类	是非类
请问棒棒堂一军有几个人?	事实类	事实类
王子和毛弟一起参加淘汰赛是哪一期?	事实类	事实类
谁有仁的弟弟的照片呀?	需求类	需求类
李连杰出生在哪?	事实类	事实类
09央视春晚哪里去了?	需求类	事实类
周杰伦2009年新电影的名字叫什么?	事实类	事实类
马天宇是哪个选秀比赛出来的?	事实类	事实类
为什么有人喜欢张杰,有人喜欢魏晨?	评价类	原因类
有多少喜欢魏晨的朋友呢	事实类	事实类
中国有多少中乐器?	事实类	事实类
那个网站看现场山寨春晚?	推荐类	需求类
韩庚带给我的是什么?	评价类	评价类
SJ里的韩庚哪最帅?	推荐类	推荐类
beyond的专辑有哪些?要全部的。谢谢!	枚举类	枚举类
张佑赫还有一个歌跟《不落的太阳》可像,叫什么?	事实类	事实类
周笔畅多大啊?	事实类	事实类
能说一下vae的所有原创单曲吗?	枚举类	枚举类
谁有很high的DJ音乐	推荐类	推荐类
在见在也不见是哪首歌的歌词啊????	需求类	事实类
萧亚轩最近有新歌吗?	是非类	是非类
组合js的图片谁有?	需求类	需求类
the one。 SS501的URL?	需求类	需求类
张韶涵出道了几年?	事实类	事实类
三只的最新专辑大概几时候出来啊?	事实类	事实类
刘德华最进做了什么	描述类	描述类
林俊杰最近会出现在哪里?	事实类	事实类
杨丞林的歌曲好听吗???	评价类	评价类
谁有五月天的阿信的详细介绍啊	描述类	描述类
今年张学友到过哪些地方开演唱会?	枚举类	枚举类
贝多芬出生在哪?	事实类	事实类
VAE的专集《自定义》在哪里能买到?	需求类	需求类
周杰伦和林俊杰谁的声音好听?	评价类	评价类
喜欢一个明星真的会痛苦吗?	评价类	评价类
有谁知道罗志祥的《我不会唱歌》的伴奏哪有下吗?	需求类	需求类
说好的幸福呢MV里那女的有知道么?	事实类	事实类
梁静茹哪首歌是周杰伦写的?	事实类	事实类
谁有张娜拉歌曲的歌词?(随便一首都行)	需求类	需求类
你认为滨崎步最经典的MV是?	推荐类	推荐类
Twins几时复出?	事实类	事实类
搜索简谱要去哪个网站	需求类	推荐类
周杰伦08最新专辑几月份发行	事实类	事实类
张韶涵几岁	事实类	事实类
JAY九张专辑每张的主打歌分别是哪首 ?	枚举类	枚举类
陈楚生开的是什么车?	事实类	事实类
张学友的歌的魅力在哪?	评价类	评价类
谁知道不要说再见的歌词?	需求类	需求类
谁能给我 占有 的歌词	需求类	需求类
音乐中的混音是什么?	描述类	描述类
谁有JAY新专辑的所有歌词?	需求类	需求类
爱向着我来的那一天的歌词是什么?	需求类	事实类
《豪杰春香》的<有必要不好意思吗>中文意思	描述类	描述类
有首歌的歌词是 (女:啊~啊~啊~) 知道是谁唱的?	事实类	事实类
我想牵着你的手的歌词?	需求类	事实类
有谁知道旋律死亡的金属乐队名字。,	事实类	事实类
今夜你会不会来,你的爱还在不在?一个女的唱的,歌的名字是什么啊?	事实类	事实类
谁有零壹乐队李小龙MP3!能否分享!!!	需求类	需求类
东方神起 和SJ 的演唱会 你会去哪一个呢 ?? (选一个)	评价类	评价类
湖南卫视初一至初五中哪天早上几点播张杰的演唱会	事实类	事实类
蔡依林的演唱会有过什么名字	枚举类	枚举类
C.K和光光合唱的《伤心的歌》的歌词?	需求类	事实类
谁有周董的帅照片?	需求类	需求类
东方神起中每个人的生日是多少?	枚举类	枚举类
东方神起的家庭成员为多少人?	事实类	事实类
北京哪里有东方神起代言的店,或者是有卖他们很多东西的地方?	需求类	需求类
在哪里最有可能遇到东方神起其中的一位?	推荐类	推荐类
周杰伦本人属于哪种类型?	评价类	描述类
王力宏和周杰伦到底谁更大牌	评价类	评价类
郑源在哪年是最红的呀?	事实类	事实类
谁有林俊杰歌迷群?	需求类	需求类
周杰伦的英文名是什么?(是他歌迷就一定要回答哦我也是他歌迷)	事实类	事实类
谁能帮我找到这首歌的歌词?歌名叫我们都在怀念过去	需求类	需求类
小情歌的歌词谁有?	需求类	需求类
为什么 查不到 《发现》 路绮欧 的这首歌呢?	原因类	原因类
学吉他的网站谁有可以介绍一个吗	需求类	推荐类
有什么吉他速成的办法	方法类	方法类
什么样的歌曲才听不腻	推荐类	描述类
有谁推荐一款好的录歌的软件?	推荐类	推荐类
"谁有""为什么会喜欢上你""的歌词(中文版)?"	需求类	需求类
谁有好的歌介绍两个?	推荐类	推荐类
周杰伦的快歌听起来很有节奏感,为什么有些人不喜欢听?	原因类	原因类
音乐的魅力在哪里?	评价类	评价类
有谁有简单的琴谱?	需求类	需求类
谁有吉他的乐谱谢谢	需求类	需求类
谁能帮我这个五线谱翻译成简谱?	需求类	需求类
哪个网站的小提琴谱又多又全?	需求类	推荐类
6根弦的是什么?这很简单,对吧!!!!!	事实类	枚举类
2岁的小孩适合练小提琴么???	是非类	评价类
谁知道《我最闪亮》的曲谱??!	需求类	需求类
钢琴849是几级的水平?	事实类	事实类
是怎么样才知道最近流行的歌曲?	方法类	方法类
李宇春与陈楚生合唱的<<深深的祝福>>歌词?	需求类	事实类
SM公司的人最小要几岁的??	事实类	事实类
最简单的吉他入门书谁知道哪有,要最基础的	需求类	需求类
现在明星一般都是用什么风格的吉他啊?	事实类	事实类
买吉他需要注意哪些问题?	描述类	描述类
吉他要学多找时间才能熟练的弹出一首的曲子啊?	事实类	事实类
我想知道 爱乐团 天涯 的歌词急 知道的请告诉我 谢谢	需求类	需求类
周杰伦什么时候能找到自己的另一半呢	评价类	评价类
QQ音乐播放器的歌曲在我的电脑那里?	事实类	方法类
周杰伦还有多少人气?	事实类	评价类
福州哪里有卖至上励合的贴纸海报或EP	需求类	需求类
类似飞向别人的床的歌?	推荐类	推荐类
谁知道明道的作品啊!!	枚举类	枚举类
谢霆锋的任意一个专集名?	枚举类	枚举类
谁告诉我〈婚礼〉插曲〈别离开〉的歌词啊???	需求类	需求类
有哪些MV是张杰和谢娜一起的?	枚举类	枚举类
东方神起跟飞轮海比,哪个更受欢迎。	评价类	评价类
黄家驹演唱会在哪?	事实类	事实类
周杰伦何时再出专集?	事实类	事实类
周杰伦有几部专集	事实类	事实类
刘德华的歌有多少专集```	事实类	事实类
喜欢杰伦的朋友.你们最喜欢那一个专集?	推荐类	推荐类
最近有多少人听了何洁的新专辑?	事实类	事实类
张靓颖和何洁,你们喜欢谁?	评价类	评价类
李贞贤是哪里的人?韩国的吗?	事实类	事实类
家驹为什么能写出这么经典的歌??	原因类	原因类
不知道神起的哥哥们最近常在哪里?	事实类	事实类
南宁哪里有卖11.25SJ-M演唱会的票?急~~~~	需求类	需求类
潘玮柏进期将在那举行演唱会?	事实类	事实类
在你心中是否爱BEYOND依然???	评价类	评价类
‘17号-但是梦只会更远’ 这首歌曲是不是有苏打绿青峰的演唱啊(结尾部分)?	是非类	是非类
东方神起谁喜欢啊,喜欢哪个人啊?	推荐类	推荐类
东方神起,谁知道他们的名字呢	枚举类	枚举类
谁能给我东方神起的手机铃声?	需求类	需求类
潘玮柏多少岁拉?	事实类	事实类
你们谁知道潘玮柏啊?	描述类	描述类
有人喜欢李小龙么?	评价类	评价类
sj-M和至上励合,你喜欢谁?	评价类	评价类
刘亦菲的粉丝都叫“小包子”吗?	是非类	是非类
谁有SJ的歌曲的乐谱?	需求类	需求类
谁有周杰伦(JAY)的图片?	需求类	需求类
飞轮海和棒棒堂你比较看好哪个?	评价类	评价类
山野的家乡在哪里?	事实类	事实类
谁有比较清新的歌啊?	推荐类	推荐类
有谁能介绍自己喜欢的歌让我也分享下吗??	推荐类	推荐类
有谁知道《蓝调江南》这本书	是非类	事实类
谁有无法证明不是粤语的歌词	需求类	需求类
杨丞琳和潘玮柏拍的电影是什么	事实类	事实类
张韶涵和杨丞琳,你们更支持谁?	评价类	评价类
谁知道张杰的网站?	事实类	需求类
周杰伦的专辑多少钱啊?	事实类	事实类
在哪可以听到东方神起的《你为什么会喜欢我》	需求类	需求类
一把好的电吉他多少钱呢?	事实类	事实类
艾薇儿有没有演过电影?	是非类	是非类
jay的新专集会突破销量最高记录吗?	是非类	是非类
刘德华销量最好的是哪个专辑?	事实类	事实类
周杰伦那首歌的歌词最长???	事实类	事实类
为什么南拳妈妈会有这样的名字?	原因类	原因类
周杰伦适合什么样的女生~	评价类	评价类
四手连弹的曲子单手能弹得出来吗?	是非类	是非类
谁有 “爱的翅膀”的钢琴谱吖。	需求类	需求类
有没有人和我练一样的钢琴曲?	是非类	推荐类
谁有激情的钢琴曲啊!	推荐类	推荐类
林俊杰啥时还出专辑?	事实类	事实类
林俊杰现在捐了多少钱了	事实类	事实类
王力宏是哪个大学毕业的?	事实类	事实类
杰伦明天就出新专辑了,有什么想法拉???	评价类	评价类
谁知道杰伦的专辑?知道的Q我!	事实类	事实类
至上励合在哪开过演唱会嘿?~	枚举类	枚举类
怎么看一些吉他谱子,比如《加洲旅馆》	方法类	方法类
任贤齐的歌一共有几首呢	事实类	事实类
最悲伤的旋律,最伤感的音乐?谁有?	推荐类	推荐类
刘德华最经典的演唱会是那一场啊?	事实类	推荐类
HIT5的歌曲在哪下呀?	需求类	需求类
刘德华会在多大结婚?	事实类	事实类
花儿乐队拿过什么奖?	枚举类	枚举类
哪些网站有较多的纯音乐	需求类	枚举类
谁能给我1个<怎么忽然就成了这样>这首歌的完整歌词么?	需求类	需求类
最后一句歌词是:管风里是谁...女歌手粤语唱的是什么歌?	事实类	事实类
BEYOND是多少年解散的?	事实类	事实类
黑涩会MM制服是多长的?	事实类	事实类
黑涩会美眉和棒棒堂分别有几个人	枚举类	枚举类
韩庚是哪国人阿?	事实类	事实类
谁有棒棒堂第一次演唱会的视频	需求类	需求类
歌坛有没有比周杰伦好的歌手?	评价类	推荐类
张杰是几岁学跳舞的啊???	事实类	事实类
张杰的专辑《明天过后》中哪几首拍了MV啊?	枚举类	枚举类
李连杰是哪一年进的好莱呜的?	事实类	事实类
春晚有多少偶像明星	枚举类	枚举类
元旦晚会,大家有什么好的建议吗?	评价类	评价类
09年春节晚会有那些精彩的节目?	推荐类	枚举类
东方卫视2009元宵晚会时间?	事实类	事实类
马天宇的签售地址,知道的告诉我~~	需求类	事实类
至上励合所参加的综艺节目有哪些?	枚举类	枚举类
体积最小的乐器是什么乐器?	事实类	事实类
《爱情和战争》中开头的是什么乐器?	事实类	事实类
相信爱中共有多少位明星?	事实类	事实类
在SM里有多少明星	事实类	事实类
明星会玩游戏吗?	是非类	是非类
怎么样才算是合格的明星?	评价类	描述类
周杰伦哪个时候才走红的?	事实类	事实类
男星女星人气排行?	推荐类	推荐类
棒棒堂的生日各是多少?	枚举类	枚举类
阿娇住在哪?	事实类	事实类
神起5只的生日各是多少?	事实类	枚举类
林志颖有哪里电影?	枚举类	枚举类
britney的新单曲叫什么?	事实类	事实类
东方神起反转剧哪有下~不要迅雷的下载``下不了```	需求类	需求类
唐禹哲新发的专辑叫啥啊?	事实类	事实类
jay专辑是8月初吗?	是非类	是非类
张杰的专辑在哪能买到	推荐类	需求类
有谁知道《无与伦比的美丽》这首歌的歌词!	需求类	需求类
张杰的新专辑《明天过后》9月几日发行	事实类	事实类
刘德华多少年出生	事实类	事实类
林俊杰发过几张专集?	事实类	事实类
周杰伦出的新专集怎么样!	评价类	评价类
释小龙的女朋友叫什么??	事实类	事实类
飞轮海下一站的演唱会是在哪里	事实类	事实类
jay是多少年开一次演唱会?	事实类	事实类
谁知道 大嘴巴 新专辑里 永远在身边 的原曲叫什么?	事实类	事实类
谁能告诉我周杰伦的电话	事实类	事实类
王力宏的新专集里每个MV都讲的什么故事?谢谢哦!	描述类	枚举类
东方神起都有几盘专集	事实类	枚举类
你们喜欢那个明星呢.和我一样吗?	推荐类	推荐类
明星到底靠的是什么?	描述类	评价类
在什么网可以设计免费的明星签名?	评价类	需求类
到底是啥歌词?	事实类	事实类
谁有张杰的图 要很帅的	需求类	需求类
王心凌跟谁比较配	推荐类	推荐类
SHE新专辑的所有歌曲的名字是什么?	枚举类	枚举类
谁知道有胡彦斌的歌的网站??	需求类	需求类
最近哪个明星的歌曲最好听?	推荐类	推荐类
有谁会永远记住你的生日	评价类	推荐类
陈楚生来自哪个省?	事实类	事实类
张学友出过几张专集	事实类	事实类
小虎队还有人喜欢吗?	评价类	评价类
小虎队成员的外号各是什么啊?	事实类	枚举类
SJ每个成员的生日是多少?	枚举类	枚举类
再说声Salanghasyoud的歌词是?	需求类	事实类
谁有超级激情摇滚的音乐?	推荐类	需求类
哪个乐队唱的歌好听?	推荐类	推荐类
中国EMO风格的乐队有那些???	推荐类	枚举类
Beyond乐队是一支怎样的乐队?	评价类	评价类
在哪能找到Flyleaf乐队的详细资料	需求类	描述类
五月天是唱什么歌出名的	事实类	事实类
飞轮海演唱会地点在哪里????	事实类	事实类
周杰伦和蔡依林在蔡依林的演唱会上跳舞.那时是蔡依林的什么歌?	事实类	事实类
王力宏在上海的人气高吗?最好是上海人回答啊?	评价类	评价类
JAY的《说好幸福呢》的歌词谁知道?	需求类	需求类
谁知道why的王子这首歌的歌词?	需求类	需求类
你知道周董的新歌叫什么吗?	事实类	事实类
何炅在哪部戏里演过皇帝	事实类	枚举类
有什么东方神起或superjunior的好看视频?	推荐类	推荐类
谁知道东方神起咒文中文版的下载方法	方法类	方法类
