打开我的浏览器	app	app
打开qq浏览器	app	app
打开音乐播放器	app	app
启动浏览器	app	app
他开酷狗	app	app
帮我搜索三国杀	app	video
打开极品飞车	app	app
公交查询	app	bus
打开搜狐新闻	app	video
图库	app	app
打开德州扑克	app	app
请打开qq	app	app
camera360	app	app
我想上qq	app	app
打开今天朝记事本软件	app	app
进入手机qq	app	app
打开优酷视频	app	video
搜索米聊	app	app
济宁到潍坊的，车。	bus	bus
从北海到东莞的汽车。	bus	bus
从汕头到西安的汽车。	bus	bus
从东莞去北海的汽车。	bus	bus
从南昌到长沙的汽车。	bus	bus
帮我查一下温州到汉中的汽车。	bus	bus
去肇庆市怎么坐车？	bus	bus
帮我查一下赣州到厦门的汽车。	bus	bus
4的平方根的立方	calc	calc
45与53的差的倒数	calc	calc
35的平方根	calc	calc
27的立方根的平方	calc	calc
123和34的积等于多少	calc	calc
2立方	calc	calc
45与32相差多少	calc	calc
3的平方除以2的立方的商减去4的平方根加3	calc	calc
虎林市电影院正在上映的大片	cinemas	cinemas
查询福建电影院的热映电影	cinemas	cinemas
嘉禾电影院正在上映的大片	cinemas	cinemas
电影钢铁侠并论。	cinemas	cinemas
麻烦帮我查下万达最近播放哪些电影	cinemas	cinemas
附近有没有电影院啊？	cinemas	cinemas
那你告诉我最新的热门电影吧。	cinemas	cinemas
艺轩电影院最近上映的电影有哪些	cinemas	cinemas
把莫若的电话号码发送给反面教材	contacts	contacts
把张三的电话发给李四	contacts	contacts
把千哥的电话号码发给萌萌	contacts	contacts
把吴琪的电话号码发给妈咪	contacts	contacts
把上官围的电话发给戴勋	contacts	contacts
打开联系人	contacts	contacts
新建联系人方超幺五五六四二五幺七七七	contacts	contacts
陈周的电话号码是多少	contacts	contacts
添加一条通讯录姓名张守刚号码是13811725158	contacts	contacts
新建联系人陈旭东电话幺三八零九二九六幺九六	contacts	contacts
素烩汤。	cookbook	cookbook
麻辣豆腐怎么做啊？	cookbook	cookbook
大薯条怎么做？	cookbook	cookbook
今晚红烧肉的做法。	cookbook	cookbook
皮冻的做法。	cookbook	cookbook
腊鱼头怎么做？	cookbook	cookbook
帮我看一下糖醋排骨怎么烧？	cookbook	cookbook
小军儿炖土豆该怎么做？	cookbook	cookbook
牛肉怎么烧	cookbook	cookbook
桂林米粉，哦。	cookbook	cookbook
红烧肉要哪些材料了	cookbook	cookbook
麻婆豆腐怎么做	cookbook	cookbook
艺锅肉怎么做？	cookbook	cookbook
怎样做肉类？	cookbook	cookbook
来做烧卖。	cookbook	cookbook
教我煮红烧排骨	cookbook	cookbook
酸菜鱼怎么烧的？	cookbook	cookbook
酱牛肉怎么做	cookbook	cookbook
你如何做螃蟹？	cookbook	cookbook
放鱼怎么做？	cookbook	cookbook
怎样给宝宝做胡萝卜泥。	cookbook	cookbook
桂花糕。	cookbook	cookbook
拌面该怎么做？	cookbook	cookbook
酒鬼花生怎么做？	cookbook	cookbook
怎么做番茄汤	cookbook	cookbook
腰花可以怎么做？	cookbook	cookbook
了，鸡蛋怎么做？	cookbook	cookbook
热狗了。	cookbook	cookbook
鸡蛋怎么炒最好吃？	cookbook	cookbook
鲜肉玉米羹怎么做？	cookbook	cookbook
人心无穷烧肉的做法。	cookbook	cookbook
酱油汁的做法。	cookbook	cookbook
请问红烧茄子怎么做？	cookbook	cookbook
做酸菜鱼。	cookbook	cookbook
糖醋藕怎么做？	cookbook	cookbook
搜索西红柿的做法。	cookbook	cookbook
刀削面怎么样做。	cookbook	cookbook
土豆怎么做才好吃？	cookbook	cookbook
地三鲜怎么做？你？	cookbook	cookbook
鸡蛋怎么做？	cookbook	cookbook
保险，酸辣土豆丝怎么炒？	cookbook	cookbook
怎样煮酸甜排骨。	cookbook	cookbook
鸡怎么烧	cookbook	cookbook
烤鸡翅怎么做呀？	cookbook	cookbook
北京烤鸭做法。	cookbook	cookbook
糖醋排骨怎么做呢	cookbook	cookbook
糖醋里脊啊，啊	cookbook	cookbook
糯米肉怎么做？	cookbook	cookbook
制作酸梅汤怎么做？	cookbook	cookbook
肉炒饭怎么做？	cookbook	cookbook
咸鸡，的制作方法。	cookbook	cookbook
我想听回锅肉做法。	cookbook	cookbook
啤酒鸭怎么做？	cookbook	cookbook
即鱼汤怎么做？	cookbook	cookbook
板栗如何烧？	cookbook	cookbook
怎么做馒头	cookbook	cookbook
国画怎样做土豆烧鸡块	cookbook	cookbook
有油炸酱料怎么做？	cookbook	cookbook
面条怎么样煮啊？	cookbook	cookbook
做卤菜需要什么材料？	cookbook	cookbook
冰激凌怎么做哦	cookbook	cookbook
苹果麦片粥需要哪些材料？	cookbook	cookbook
布丁需要哪些材料？	cookbook	cookbook
炖鸡	cookbook	cookbook
有什么下酒菜吗	cookbook	chat
怎么做番茄炒蛋？	cookbook	cookbook
清蒸武昌鱼。	cookbook	cookbook
怎样做面筋	cookbook	cookbook
白萝卜汤怎么做？	cookbook	cookbook
腐乳肉怎么做？	cookbook	cookbook
鸡煲啊！	cookbook	cookbook
鱼香茄子怎么做	cookbook	cookbook
青鱼做法视频	cookbook	cookbook
请问酸辣土豆丝是怎么炒的	cookbook	cookbook
帮我搜索一下羊肉面片。	cookbook	cookbook
汉堡。	cookbook	cookbook
回锅肉怎么做啊	cookbook	cookbook
煮水饺。	cookbook	cookbook
烧鸡块怎么做？	cookbook	cookbook
怎样做糖醋排骨。	cookbook	cookbook
羊肉怎么烧？	cookbook	cookbook
梅菜扣肉怎么做啊？	cookbook	cookbook
小鸡炖蘑菇的做法爸	cookbook	cookbook
红烧鱼怎么烧啊？	cookbook	cookbook
死肉怎么烧好吃？	cookbook	cookbook
做凉拌青瓜炒肉用哪些材料？	cookbook	cookbook
请问牛排怎么做	cookbook	cookbook
豆豉鲮鱼油麦菜	cookbook	cookbook
日本豆腐的做法。	cookbook	cookbook
哈哈，吃了水煮鱼怎么做？	cookbook	cookbook
距离12点还有多少秒	datatime	datatime
中国香港现在是什么时间	datatime	datatime
现在的准确时间是几点	datatime	datatime
消费者权益日是不是3月15号	datatime	datatime
现在葡萄牙是几点	datatime	datatime
几点了	datatime	chat
我想写一个邮件	email	email
我想转发这封邮件	email	email
发邮件	email	email
我要写一条邮件	email	email
我想全部答复	email	email
替我回复邮件	email	email
开启邮件	email	email
给我写一封邮件	email	email
打狗棍播出时间表	epg	epg
电视上播放什么节目	epg	epg
chc高清的节目单	epg	epg
北京生活频道节目单	epg	epg
哪个台播出爱情公寓	epg	epg
爸爸去哪几点结束呀	epg	chat
越策越开心这个节目是哪个台播的呀？	epg	epg
什么时候有泰囧	epg	epg
湖南卫视电视节目表	epg	epg
中央三今天有什么节目	epg	epg
今天晚上天津卫视放什么年岁月	epg	epg
湖南卫视节目录	epg	epg
湖南卫视的快乐大本营什么时候播	epg	epg
淮南电视台综合频道节目。	epg	epg
明天什么节目啊？	epg	epg
现在浙江卫视在放什么节目	epg	epg
CCTV-9的节目单	epg	epg
湖南卫视现在在播什么	epg	epg
浙江卫视今晚有中国好声音吗？	epg	epg
最近下午有什么电影？	epg	epg
中央一一台有什么节目吗	epg	epg
青海卫视频道的节目单	epg	epg
中央一套昨天的新闻联播	epg	epg
前天中央一套的节目单	epg	epg
帮我查下下周演新闻联播	epg	epg
电视回看安徽卫视	epg	epg
十二频道今天有什么节目	epg	epg
12月9日北京卫视节目单	epg	epg
搜索东方卫视的电视节目。	epg	epg
财经频道今天有什么节目	epg	epg
浙江高清台的节目单	epg	epg
等一下七点半湖南卫视会播出什么节目	epg	epg
四川卫视频道的节目单	epg	epg
2012年的恐怖电影	epg	video
现在有什么好看的电视剧吗？	epg	epg
安徽卫视今晚放什么节目啊？	epg	epg
上海去武汉的航班	flight	flight
从重庆到武汉的航班	flight	flight
帮我查一下明天广州到长沙的航班	flight	flight
杭州到郑州飞机票	flight	flight
查一下重庆到贵阳的机票。	flight	flight
我想订8月15晚上北京飞合肥的机票	flight	flight
九月二十号广州飞北京的航班	flight	flight
帮我订明天早晨的机票	flight	flight
到贵阳的航班。	flight	flight
后天从深圳到成都的航班	flight	flight
今天新余到北京的航班	flight	flight
查询上海到北京的航班。	flight	flight
查询郑州到上海的航班。	flight	flight
明天到佛山的航班	flight	flight
明天去成都的航班有几趟	flight	flight
八月十九号到成都的航班	flight	flight
4月28号上海到南昌的航班	flight	flight
去重庆的机票多少钱。	flight	flight
潍坊到北京机票明天的	flight	flight
查一下明天青岛飞往上海的飞机都有哪一些都是几点的	flight	flight
二十五日去深圳的航班	flight	flight
阑尾炎	health	health
内痔怎么办？	health	health
腹泻。	health	health
唇腭裂。	health	health
男性节育	health	health
高血压怎么办吧	health	health
肩关节周围炎	health	health
失明了怎么办？	health	health
贫血怎么治？	health	health
得了灰指甲怎么办呢？	health	health
给我查一下糖尿病如何治疗？	health	health
如何治疗脚臭。	health	health
急性胃肠炎。	health	health
手癣怎么治疗？	health	health
小孩子有肺炎的治疗方法有哪些？	health	health
淋病怎么治？	health	health
脊髓损伤。	health	health
烧伤怎么治疗啊？	health	health
上一期15选5的中奖号码是多少？	lottery	lottery
买一注5月30号开奖的大乐透	lottery	lottery
第50000期福彩双色球	lottery	lottery
搜索大乐透的号码资讯	lottery	lottery
今天大乐透开什么号啊	lottery	lottery
帮我买两注双色球	lottery	lottery
查看双色球开奖	lottery	lottery
找找大乐透的获奖号码	lottery	lottery
常州在哪	map	map
薛山西路怎么走	map	map
查一下从上海到安徽东至县的路线	map	map
龙王庙在哪里	map	map
从这里去瑞金路怎么走	map	map
灌阳县位置	map	map
导航到望江西路上去	map	map
武汉理工大学在哪	map	map
搜索凤凰古城位置	map	map
从这里去科大讯飞如何去	map	map
迎宾路在哪	map	map
导航到江门	map	map
云浮在哪里	map	map
我去杨家坪该怎么走	map	map
去汽车东站怎么走	map	map
导航到石化小学	map	map
沿途的科大讯飞	map	map
到安徽芜湖怎么走	map	map
飞机场怎么走	map	map
去永康怎么走	map	map
我要到徐家汇怎么走	map	map
帮我查一下我所在的位置	map	map
周口在哪里	map	map
昨天恒大比赛结果是什么？	match	match
中超赛事预告，啊！	match	match
下个星期中国足球超级联赛淘汰赛的赛事前瞻	match	match
篮球赛事预告。	match	match
中超比分。	match	match
NBA热火季前赛的赛程。	match	match
中超的比赛预告。	match	match
中超的比赛时间。	match	match
给李光发短信	message	message
发送短信给黄启超	message	message
给刘俊发短信	message	message
给夏磊发短信	message	message
发短信给张三的186的号码我今天请他吃饭	message	message
给陈易云发短消息	message	message
给一欧阳杰发短信说你是傻逼	message	message
我要给陈永信息	message	message
发短信呢	message	message
给肥老发信息	message	message
发送短消息	message	message
给茵茵发短信	message	message
给黄卫国发短信	message	message
给胡克发短信	message	message
给岚岚发短信	message	message
发短讯给曹建阳	message	message
查看短消息	message	message
给李占峰发短信你现在在做什么	message	message
发短信给张全三移动的号码我今天请他吃法	message	message
给徐茶叶发短信	message	message
发短信给万若里说你是个傻逼	message	message
来一首一生最爱。	music	music
我要听那首最美的时光	music	music
再来一首飞得更高。	music	music
我要听稻香	music	music
来首歌吗？	music	music
来一首飞得更高了说完了	music	music
播放一首倒带来听一听	music	music
个来一首路灯下的小姑娘。	music	music
我要听流行歌曲	music	music
你不来一首涛声依旧，那你。	music	music
来一首剑侠情缘	music	music
来一首歌尔勤县	music	music
哦来一首传奇	music	music
胡歌忘记时间	music	video
来一首钟汉良的视觉动物	music	music
徐良唱的歌	music	music
赵唱一首歌吧	music	music
陈奕迅有什么歌啊	music	chat
我想听s h e 的中国话	music	translation
我想听笨这首歌。	music	music
来首青花瓷	music	music
你可以帮我点歌吗	music	chat
我要点新闻。	news	news
我要看新闻玩不？	news	news
查一下今天早上的新闻。	news	news
后天新闻	news	news
今天有什么好的新闻	news	news
我想听最新军事新闻。	news	news
哦，今日头条新闻。	news	news
我想看新闻。	news	news
我想听听钓鱼岛的新闻。	news	news
天最新新闻。	news	news
我要听昆明新闻。	news	news
看新闻。	news	news
我想跟今天的新闻。	news	news
给我找到今天的新闻。	news	news
我要听个新闻。	news	news
读新闻听。	news	news
温州今天的新闻	news	news
我想听搜狐新闻	news	news
查一下新闻。	news	news
辛夷坞原来你还在这里小说	novel	novel
陈忠实的爱情小说《白鹿原》	novel	novel
都市言情小说何以笙箫默	novel	novel
搜一下小说。	novel	novel
我要看军事武侠小说	novel	novel
给我讲一个长篇小说。	novel	novel
我要看现代言情小说	novel	novel
查询饶雪漫的言情小说	novel	novel
毛泽东诗词，咏梅。	poetry	poetry
来一首李白的诗。	poetry	poetry
来首归家。	poetry	poetry
茅屋为秋风所破歌杜甫。	poetry	poetry
我朗诵唐诗。	poetry	poetry
白居易的诗词。	poetry	poetry
你不会念唐诗吗？	poetry	poetry
背离骚给我听。	poetry	poetry
给我来首诗。	poetry	poetry
买，来一首诗李白的诗。	poetry	poetry
背诵悯农。	poetry	poetry
读一首古诗给我听。	poetry	poetry
读一首毛泽东的诗。	poetry	poetry
读一首古诗给我听吧！	poetry	poetry
来一首白居易的诗了。	poetry	poetry
给我朗诵一下岳飞的满江红。	poetry	poetry
来首山口。	poetry	poetry
人死原知万事空下一句是什么？	poetry	poetry
念一首唐诗给我听。	poetry	poetry
搜索腊梅。	poetry	poetry
朗诵李白的静夜思。	poetry	poetry
同是天涯沦落人下一句。	poetry	poetry
抽刀断水水更流的下一句是什么？	poetry	poetry
来一首水调歌头。	poetry	music
让读一下沁园春雪毛泽东。	poetry	poetry
来时打来首唐诗绝句。	poetry	poetry
刘禹锡的秋词。	poetry	poetry
给我背一首唐诗李白写的	poetry	poetry
背首唐诗来听啊！	poetry	poetry
背一下游子。	poetry	poetry
牧童骑黄牛的下一句是什么？	poetry	poetry
给我搜索唐诗。	poetry	poetry
盖竹柏影也前面一句诗是什么？	poetry	poetry
来一首毛泽东的词。	poetry	poetry
调频fm九十九点二	radio	radio
请帮我调频105山东人民广播电台生活频道	radio	radio
可以帮我收听安庆新闻综合广播	radio	radio
请帮我调频98.2山东人民广播电台经济台	radio	radio
请帮我调频90.2连云港经济广播电台	radio	radio
我好想听新城知讯台	radio	radio
调幅am六百五十一	radio	radio
收听安徽广播电台。	radio	radio
再猜一个谜语。	riddle	riddle
讲个猜谜语的。	riddle	riddle
出个脑筋急转弯的。	riddle	riddle
来个谜语吧！	riddle	riddle
搜索一个字谜了。	riddle	riddle
啊，猜个谜语给我听。	riddle	riddle
那就来个字谜吧！	riddle	riddle
来个脑筋急转弯，那你。	riddle	riddle
猜谜语，听了。	riddle	riddle
哥猜个谜语。	riddle	riddle
请给我打一个谜语。	riddle	riddle
8:10提醒我上班。	schedule	schedule
修改明天和张三去步行街的提醒为去国购	schedule	schedule
什么地方开会	schedule	chat
十分钟以后叫我。	schedule	schedule
提醒	schedule	schedule
一分钟后提醒。	schedule	schedule
下午两点叫醒我。	schedule	schedule
8:10整叫我起床。	schedule	schedule
今天早上8:10叫我起床。	schedule	schedule
下个月的提醒都有哪些啊	schedule	schedule
b股的股票呢	stock	stock
查询华峰氨纶的股票	stock	stock
真达林业的股票怎么样	stock	stock
我想查询上证指数的股票	stock	stock
科大讯飞股票价格	stock	stock
查询中信国安的股票	stock	stock
浪莎的股票	stock	stock
陕西金叶近日的涨幅情况	stock	stock
万科a股票	stock	stock
吉林敖东	stock	tvchannel
中国联通的股票涨还是跌	stock	stock
查询腾讯股票	stock	stock
中国石化的股票	stock	stock
国祥	stock	contacts
黔轮胎的走势如何	stock	stock
查询东方集团的股票	stock	stock
苹果公司股票每股多少钱啊	stock	stock
苏泊尔股价大跌	stock	stock
阿勋中集集团的股票	stock	stock
查询重庆水务股票	stock	stock
中石油今天的股价	stock	stock
目前六零零零六九的市值啥样	stock	stock
亚洲能源物流股票	stock	stock
帮我查一下江西铜业股票	stock	stock
打电话给一十一	telephone	telephone
打电话给谢文豪	telephone	telephone
打电话给吴荣因	telephone	telephone
呼叫小惠	telephone	telephone
打给我三姐家里的电话	telephone	telephone
呼叫老公	telephone	telephone
打电话给陈正成	telephone	telephone
打电话给何健	telephone	telephone
打电话给陈永聪	telephone	telephone
给熊媛媛打电话	telephone	telephone
呼叫琳琳	telephone	telephone
打电话麦亚伦	telephone	telephone
打电话给黄组织	telephone	telephone
打电话给地瓜	telephone	telephone
打电话给王大头	telephone	telephone
呼叫晚欲强	telephone	telephone
请帮我接电话	telephone	telephone
打电话给斌少	telephone	telephone
打电话零八	telephone	telephone
打电话给贾青子	telephone	telephone
给张宁打电话	telephone	telephone
重庆到无锡的火车票	train	train
晋江到温州的火车票	train	train
查一下南京到上海的火车注意谢谢	train	train
从东莞到厦门的火车票	train	train
火车南京到衡水	train	train
后天去南京的火车	train	train
查宁波到北京的火车票	train	train
搜索郑州到南阳的火车票	train	train
我要订一张到宁波的动车票	train	train
查一下杭州到宁波的火车票	train	train
从武汉到杭州的火车	train	train
帮我查一下淮安到石家庄的火车	train	train
去烟台的火车	train	train
查一下吉安至武汉的火车	train	train
查一下广州到信阳的火车票	train	train
帮我搜索一下宜春到长沙的火车	train	train
帮我定一张去镇江的动车票	train	train
明天去贵阳的火车	train	train
郑州到许昌的火车	train	train
查询武汉到茂名的火车	train	train
十堰至武汉火车票	train	train
姜堰到南京的火车	train	train
合肥到深圳的火车票	train	train
中国移动通信的英语怎么说	translation	translation
我想出去旅游英文怎么说	translation	translation
翻译我想去远方	translation	translation
翻译这个多少钱	translation	translation
我要买电脑的英语怎么说	translation	translation
我们一起去玩吧用英文怎么说	translation	translation
买东西翻译成英语	translation	translation
完毕用英文怎么说	translation	translation
乳房的英语怎么说	translation	translation
翻译我是一只狗	translation	translation
翻译睡觉了	translation	translation
说话的英文怎么写	translation	translation
明天有什么活动用英语怎么讲	translation	translation
汉堡的英语怎么说	translation	translation
内裤用英语怎么说	translation	translation
用英语怎么讲	translation	translation
我想吃汉堡包的英文怎么说	translation	translation
翻译我今天要去打网球	translation	translation
电焊机用英语怎么说	translation	translation
点击说话的英语怎么写	translation	translation
高清广东台	tvchannel	tvchannel
南京新闻频道	tvchannel	tvchannel
高清北京文艺台	tvchannel	tvchannel
东方卫视高清频道	tvchannel	tvchannel
小c 你好我想看河北卫视	tvchannel	tvchannel
CCTV6电影	tvchannel	tvchannel
切换浦口新闻综合频道	tvchannel	tvchannel
电视频道列表	tvchannel	tvchannel
央五	tvchannel	tvchannel
CCTV第一剧场	tvchannel	tvchannel
CCTV4中文国际	tvchannel	tvchannel
找河南卫视	tvchannel	tvchannel
我要看cctv五	tvchannel	tvchannel
chc-动作影院	tvchannel	tvchannel
中央10	tvchannel	tvchannel
一套高清	tvchannel	tvchannel
我想看中央五台	tvchannel	tvchannel
中央六套	tvchannel	tvchannel
CCTV-新闻	tvchannel	tvchannel
郎溪频道	tvchannel	tvchannel
合肥影院	tvchannel	tvchannel
安徽电视台	tvchannel	tvchannel
很想看安徽卫视来着	tvchannel	epg
科教频道	tvchannel	tvchannel
午夜凶铃	video	video
看最近有什么电影？	video	video
播放落日批示	video	video
福尔摩斯探案集	video	video
最新电影	video	video
看毛泽东在武汉的故事	video	video
一路向西	video	map
台剧	video	video
叶落长安电视剧	video	video
穷孩子富孩子	video	chat
神兵小将	video	video
需要你帮我推荐一下电影	video	video
古墓丽影	video	video
播放卡洛斯沙尔阿	video	music
天才碰麻瓜	video	video
死亡笔记	video	video
给我播放最近好评的电影	video	video
封神榜	video	video
光阴	video	video
最近有什么好看的电影？啊？	video	video
美国电影少年派的奇幻漂流	video	video
共同关注	video	video
蓝猫龙骑团	video	video
电视剧粘豆包	video	video
最新有什么热门电影	video	cinemas
最美好的时光便时计	video	video
最近有什么热播的电视剧。	video	video
熊出没啊	video	video
播放搞笑动漫	video	video
封神太子	video	video
有什么好看的电影没有	video	video
最近有哪些电影的资金字。	video	video
粉红女郎	video	video
你给我推荐个电影	video	video
泰国的节目	video	epg
美人心计电视连续剧	video	video
孙俪的电视剧	video	video
动作电影	video	video
我要看综艺	video	video
张绍刚的综艺节目	video	video
给我搜个电影	video	video
中国霸王花	video	video
最近流行电影。	video	cinemas
帮我搜索一下最近有什么电影可看？	video	video
新水浒传	video	video
抬头见喜	video	video
我要看巴拉小魔仙	video	video
天龙八部第二集	video	video
大西南剿匪记	video	video
荒野求	video	video
有没有九十年代热门的动漫	video	video
好评的喜剧电影	video	video
超级战舰电影	video	video
我想看电影搜索	video	video
2012年美国公告牌音乐大奖颁奖礼	video	video
喂我想看电影喂	video	video
最近有什么大片儿？	video	video
虎胆龙威	video	video
播放吸血鬼日记第二季	video	video
那金花和她的女婿	video	video
科幻篇	video	video
湖州天气	weather	weather
安徽的天气	weather	weather
我想知道浙江义乌的天气	weather	weather
外面天气如何	weather	weather
今天温度是多少	weather	weather
广州明天天气好吗	weather	weather
商丘天气	weather	weather
您好帮我查看一下明天的天气	weather	weather
明天下雨不	weather	weather
查一下台湾天气	weather	weather
株洲天气	weather	weather
常熟的天气	weather	weather
后天北京天气怎么样啊	weather	weather
朝阳的天气	weather	weather
合肥的天气	weather	weather
我想知道明天的天气如何	weather	weather
安徽省的天气	weather	weather
查询明天天气	weather	weather
为我播报明天的天气	weather	weather
重庆天气	weather	weather
你那儿天气怎么样啊？	weather	weather
桃园天气	weather	weather
打开昆明三六零手机网	website	website
进入当乐网	website	website
魔神战记	website	video
打开苹果公司的官方网站	website	website
打开我的网易	website	website
打开福州新往网	website	website
打开网址新浪	website	website
打开五五两性网站	website	website
帮我打开智能三六零的官网	website	website
请帮我打开网站	website	website
打开九幺五八聊天	website	app
打开中关村在线网	website	website
开www.china.com	website	website
请打开网页	website	website
我要上中学学科网	website	website
美女啊帮我打开网页	website	website
打开骏网一卡通	website	website
打开谷歌wap	website	app
春饼哪家好	chat	chat
那你到底是男生还是女生	chat	chat
你是帅哥还是美女	chat	chat
你只管帅哥吗	chat	chat
那你男神是谁	chat	chat
你是谁造的	chat	chat
那用什么来形容	chat	chat
你可以干什么	chat	chat
这么久在干嘛呢	chat	chat
你有多少最爱啊	chat	chat
你会说情话吗	chat	chat
你来吗	chat	chat
嘿干什么呢	chat	chat
认识俞霖霖吗	chat	chat
你是男生还是女生呀	chat	chat
是和我没话了吗	chat	chat
你认识么	chat	chat
没有其他的吗	chat	chat
是不是笨笨你觉得你笨吗	chat	chat
我说你喜欢我么	chat	chat
你是不是	chat	chat
你是哪儿人啊	chat	chat
小时候住过哪里	chat	chat
哥哥是谁	chat	chat
我去过陈中宝吗	chat	chat
我想想你刚刚说什么来着	chat	chat
你确定你能懂我说的是什么么	chat	chat
天啊是谁	chat	chat
你在犹豫什么	chat	chat
怎么考好呢	chat	chat
告诉我怎么去	chat	chat
长大了要干嘛	chat	chat
你QQ号吗诗多少	chat	chat
见谁	chat	chat
不是说你是难道是说我吗	chat	chat
会唱小星星吗	chat	chat
为什么要矜持	chat	chat
你到开心果是什么问题	chat	chat
发照片，看看你长什么样	chat	chat
太阳是不是有下雨吗	chat	weather
你知道你的名字是什么吗	chat	chat
我找男朋友了家里人不同意怎么办	chat	chat
你怎么这么猥琐	chat	chat
你特长是谁	chat	chat
搞笑吗	chat	chat
大家都说我瘦怎么办呀	chat	chat
有你漂亮么	chat	chat
你是不是有病呀	chat	chat
你需要睡觉吗	chat	chat
朱泽圻是谁	chat	chat
你和Siri是好朋友吗	chat	chat
